WWWWWWWWWWWW
WFXFFFFFFFFW
WFFTFFFFTFFW
WFFFFFTFFFFW
WFFFFFFFBFFW
WFFFFFPFFFFW
WFFFFFFFFFFW
WFFXFFFFFFFW
WFFFFFFFFFFW
WFFTFTFFXFFW
WFFFFFFFFFFW
WWWWWWWWWWWW