WWWWWWWWWWWW
WFXFFFFFFFFW
WFFTFFFFTFFW
WFTFFFTFFFFW
WFFFFTFFBFFW
WFFFFFPFFFFW
WFFFFFFFFFFW
WFFXFTFFFFFW
WFFFFXFFFFFW
WFFTFTFFXFFW
WFFFFTFFFFFW
WWWWWWWWWWWW