WWWWWWWWWWWW
WFXFFFFFFFFW
WFFTFFXFTFFW
WFTFFFTFFFFW
WFFFFTFFBFFW
WFFXFFPFFFFW
WFFFFFFTFFFW
WFFXFTFFFFFW
WFFFFXFFFFFW
WFFTFTFFXFFW
WFFFFTFFFFFW
WWWWWWWWWWWW