WWWWWWWWWWWW
WFXFTFFFFFFW
WFFTFFFFTFFW
WFTFFFTFFFFW
WFFFFTFFBFFW
WFTFFFPFXFFW
WFFFFFFFFFFW
WFFXFTFXFFFW
WFFTFXFFFFFW
WFFTFTFFXFFW
WFFFFTFFFFFW
WWWWWWWWWWWW