WWWWWWWWWWWW
WFXFFFXFFFFW
WFFTFFFFTFFW
WFFFFFTFFFFW
WFFXFFFFBFFW
WFFFFFPFFFFW
WFFFFFFFFFFW
WFFXFFFFFFFW
WFFFFFFFFFFW
WFFTFTFFXFFW
WFFFFBFFFFFW
WWWWWWWWWWWW